##################################################
#OO..OO..O....O##O....O..#...O..O..............OO#
#.OO.O.O.......O..O.....#O....#O#.......O.O...O.##
#OO..O..O..O......OO.....O#..OOO..O.....#....O...#
#...O......#O.O##.#..O.O#..O.O....O.#.#.OO#O.OO#O#
#...#...O..OO.....O.........OO.OO.O........O...#.#
#...#....O...O##O...O.....O....#.....O..O.O.O.OOO#
#.O...O..#.#OO.O.##...#...##O....O...#...#....O..#
##.###.O......#..O...O....#....O....#O.....O#..O.#
#...#O.O...#O..O.O............OO.O..O..#.##..O.OO#
#...OOO............#OO....O.O.O#.......O......O#.#
##............#O.....O......O..O.O.#.OO.O.O......#
#O...O..#...O....O..O...OO#.#OO#.........##.#O..##
#O...O..O#O..O#.#.O.O...O.O..OOO.O....O....O.O...#
#....#...#.O.O#O..O..OOO..O....O.....#...O...O.#.#
#..O...#...OO.O.O.OOO.OO..#..O..OO...O......O#..O#
#O.....O.O...O.O.#.O....O.....O...O....O...O.....#
#.O..O..O.#O..O...O.O..O..OO.OO#...O.O....#.#.O..#
#O..#O...O.O.....O#OO..O.......#.OO.OOOOOOO#..O..#
#O#O...O..#...O#O.O......O..OO...O.....O...O.....#
#O......O##....O#....O..#.OOOO.O.O..#OO........O.#
#O..OO....#.#........O....O..O#.OO.....#.O.OO....#
#.....O.....OO#OO....O.O...#.....OO.O...O.....O..#
#.....O.O....#......O..O..O...O.....O....O.....O.#
#.O.O#.......#O....O..OO@#...O#.O...OO...OO.#.O..#
#OO...OO..#.#...OO.....#....O.....OO....O#..#....#
#.O.#.O.......#.....O.O.......O...O....#...O.....#
#.OOO.O..#...O...O..#O......O..O.O##..#.##.O.....#
#O.O#..OO......OO..OO..O#..#O.O...#O#........#.OO#
#..O.O.....#...OOO..OO.#.....OO#.......#OOO..O..O#
#O.O..OO...O..O.O....OO...O.O...O..O......OO.....#
##...O....#O..OOO.O.#.OO.#......O#..O.#O...#.....#
#...O...O....O.#...O...........OO.OOO..O.O..#.#OO#
#.O.#....#.O#..#O..O....#..OO.O..O..O.#........O.#
#O#O...O.....O.O......#OOO.O#.......O....#O.#.#O##
#O.O#..O...OO....O......O.O.....O......O.OOO....O#
#....#OO...O.......#OO.O.O..#.O......#.....O..O..#
#....O.....OO....OOO..O.OO..#OO..O.....OOO.#.....#
##..OOO.#.O.........#..O..O..O..O.O.OOOO..#....O.#
#...OO....OOO......O.......O.......#........O.O..#
#O.O...#OOO....O.#...O...OO...O....OO.......#....#
#.......O.O..#...OOO..#..O..OO..O..O.OOOO.O..OO..#
#..O..O..O..O.##.OO...#..O#..O.#...OOO..O......O.#
#.....OO..OO...O.#.O..OOO..OOO....OO.........#.O.#
#..O.....O.O..O...O..##OO....O...O....#.O.O..#.OO#
#..OO.......O..O#.OOO.....O....O...#..O.O.....#O##
#...O..#...O..O........#...OO.O.O...#.O.....O....#
#O....O.O#...OO......OO.OO..O.......#..#.#..OO...#
#..#.#.....##.##O....O...O.......O..OO....O...OO.#
##################################################
